20 10
WWWWWWWWWWWWWWWWWWWW
WRWEEEWEEEWXEEEEWWXW
WEEEWEWXEEEEEEEEWWEW
WWWWWEWWWEWWWWEWWWEW
WEEEEEEXWEWEEEEEEEEW
WEWWWWWWWEWEWWWWEEEW
WEEEEEEEEEWEWXEWEEEW
WWWWWWWWWWWEWWWWEEEW
WEXXEEEEEEEEEEEEEEEW
WWWWWWWWWWWWWWWWWWWW
